NO ./path_to_the_north_texture
SO ./path_to_the_south_texture
WE ./path_to_the_west_texture
EA ./path_to_the_east_texture
F 144,238,144
C 221,160,221
011111111111111111111
10S000000000000111111
100000000000000001111
100000000000000000111
100000010000000000001
110000000000000111111
110100000000000111111
110000000001001111111
010000010001101111000
011100011101000111111
011100011101111111111
011100111111111111111
011111111111111111111
