NO ./path_to_the_north_texture
SO ./path_to_the_south_texture
WE ./path_to_the_west_texture
EA ./path_to_the_east_texture
F 144,238,144
C 221,160,221
011111111111111111111
10S000000001111111111
100000000001111111111
100000000001111111111
010101100000000000001
110111100001111111111
110101111111111111111
110001111111111111111
011110111111111111000
011110111111000111111
011110111111111111111
011110111111111111111
011110111111111111111